e 1 e e 4 e e 5
4 e e e e 8 e e
e e 2 e e 1 6 e
e 6 e 5 e e e e
e e e e 8 6 e 4
e 2 5 e e 3 e e
e 4 7 e e 2 e e
6 e e 7 e e 5 e