5 3 e e 7 e e e e
6 e e 1 9 5 e e e
e 9 8 e e e e 6 e
8 e e e 6 e e e 3
4 e e 8 e 3 e e 1
7 e e e 2 e e e 6
e 6 e e e e 2 8 e
e e e 4 1 9 e e 5
e e e e 8 e e 7 9
